............
............
.XXXXXXXXX..
.X.......X..
.X.X.X.X.X..
.X.......X..
.X.121212X..
.XXXXXXXXX..
............
............
............
............
04
