............
............
............
..XXXXXXX...
.XX.X.X.XX..
.X.......X..
.X.121212X..
.XXXXXXXXX..
............
............
............
............