............
.XXXXXXXXXX.
.X...3....X.
.X.1.....2X.
.X........X.
.X....4...X.
.X........X.
.X..4.....X.
.X.2....1.X.
.X.......3X.
.XXXXXXXXXX.
............
06