............
............
............
......XXXX..
.XXXXXX2.X..
.X.......X..
.X.......X..
.X.121XXXX..
.XXXXXX.....
............
............
............
06
