............
............
............
......XXX...
......X1XX..
..XXXXX..X..
.XX......X..
.X.212XXXX..
.XXXXXX.....
............
............
............
04
