............
............
.XXXXXXXXX..
.X.......X..
.XX21....X..
.XX12..XXX..
.X.......X..
.XXXXXXXXX..
............
............
............
............
05