............
............
............
..XXXXX.....
..X1..XXX...
..X....1X...
..XX1...X...
...XXXXXX...
............
............
............
............
04
