............
............
...XXXXXX...
.XXX....XXX.
.X2.......X.
.XXX1.....X.
...XX.1XX.X.
....XX2XX2X.
.....XXXXXX.
............
............
............
04