............
............
..XXX.......
..X1X.......
..X.XXX.....
..X..1XXX...
..X....2X...
..X.....XXX.
..X......1X.
..XXXXX2.XX.
......XXXX..
............
04