............
............
XXXXX.XXXXX.
X..1XXX2..X.
XX.......1X.
.XX.....XXX.
..X1....X...
..XXX.X.X...
....X2..X...
....XXXXX...
............
............
05