............
............
............
...XXXX.....
.XXX1.XXXXX.
.X.......1X.
.X...2...XX.
.X2..1...X..
.XXXXXXXXX..
............
............
............
06