............
............
...XXXXXX...
.XXX1...XXX.
.X.......2X.
.XX.......X.
..X.......X.
..XXXXX2XXX.
......X1X...
......XXX...
............
............
06