............
............
............
...XXX......
..XX.XXXX...
..X.....X...
..X1.0.1X...
..XXXXXXX...
............
............
............
............
05
