............
............
......XXX...
......X.X...
.XXXXXX.XX..
.X......1X..
.XX.0XX.XX..
..XXXXX1X...
......XXX...
............
............
............
06
