............
............
....XXXX....
.XXXX1.XXX..
.X2.....1X..
.X......0X..
.XXX2...0X..
...XXX..XX..
.....XX.X...
......XXX...
............
............
06