............
............
......XXX...
......X.X...
.XXXXXX.XX..
.X.......X..
.X1.OXX.XX..
.XXXXXX1X...
......XXX...
............
............
............
05
