............
............
............
......XXX...
XXXXXXX.XXX.
X..1....1.X.
XXX...10.XX.
..X.0....X..
..X..XXXXX..
..XX...X....
...XXXXX....
............
99