............
............
............
...XXXXXXXX.
.XXX1.XX1.X.
.X....0...X.
.X2..3...XX.
.XXX.....X..
...XXX23XX..
.....XXXX...
............
............
08