............
............
.XXXXXXXXX..
.X1......X..
.X.213...X..
.X.12.3..X..
.X1......X..
.XXXXXXXXX..
............
............
............
............
99